	[Help]
Caption	Справка
Button1.Caption	OK
Memo1.Lines.Strings	Версия 1.1
Автор: Роженко Сергей
http://www.grayface.chat.ru
sergroj@mail.ru

При правом клике по кнопке "Открыть" показывается список недавно открытых документов.

	[Main Form]
SSaveQuestion	Сохранить изменения в "%s"?
SSaveQuestionUntitled	Сохранить изменения в Безымянный документ?
SSaveQuestionCaption	Confirm
SReopenQuestion	Вы уверены, что хотите заново открыть "%s", отказавшись от изменений?
SReopenQuestionCaption	Confirm
Caption	Txt Tables Editor
EditX.Hint	Фиксированные Строки
EditY.Hint	Фиксированные Столбцы
SaveDialog1.Filter	Txt таблицы|*.txt|Все файлы|*.*
OpenDialog1.Filter	Txt таблицы|*.txt|Все файлы|*.*
File1.Caption	Файл
New1.Caption	Новый
Open1.Caption	Открыть
Save1.Caption	Сохранить
SaveAs1.Caption	Сохранить как...
Recent1.Caption	Недавние документы
Exit1.Caption	Выход
Edit1.Caption	Редактировать
Undo1.Caption	&Отменить
Redo1.Caption	Пов&торить
Cut1.Caption	&Вырезать
Copy1.Caption	&Копировать
Paste1.Caption	Вст&авить
Selectall1.Caption	В&ыделить все
WordWrap1.Caption	Перенос слов
InsertRow1.Caption	Вставить строку
DeleteRow1.Caption	Удалить строку
AddRow1.Caption	Добавить строку
InsertColumn1.Caption	Вставить столбец
DeleteColumn1.Caption	Удалить столбец
AddColumn1.Caption	Добавить столбец
Help1.Caption	Справка
Delete1.Caption	&Удалить
